111111111111111111111111111111111111111111111111111111111111
100010000010000001000011000000000000000000000000000000000001
100101000000000000000010000000100000000000001000000000000001
100000001000000000000000000001000000101001001000000001001011
100000000000000101000010101001000001100000000000010000100011
100000000000000000011000000000000000000100000001000010100001
11001000000000000010000111000000000P000100000000000100100001
100001000100001001000000000000000100000000001100100000010001
101101000000010000000000001000010110100000000001000000000001
100100000000100000000000010000000000000010000001000001000001
100010000000000000000000000000000000010001000000011000100001
100000000100100000010000000000100000101000100001000000000101
100000011010100000000000000010000000000010000010000000000001
100010100000000000000100000101000010000000000000E00000000001
100000000000001000000000000000000001100110000010000000100001
100000000000011010000000000100001000000100001010011010000001
110100000000000100000000100000000000000000000000000000100001
101000100000101001110000000100000000000000000000001000000001
100000000000000000000000000010001000000100000000000000000111
100000000000001000000000000000100001100000000000000000100011
111000000010000001000000000000000010000000000000100010010001
100100000001000000100000000000000000000000000001000001000001
100000000010000000000010000000000000100001000000000000001001
100001001000000000000101000100000100000001000000000000000001
110000000100100000000000000000000000000100000000000000010001
100000000000000000000001000000100000000000000000000000000001
100000000000000001101000000010000010000000000000000000000001
100000000000000000000010000000000000000000001000000000100001
100001000000000000001001000000000000001000001000000010000001
100100000000000000000000000000000000010000001000000010000101
10000000000000000000C010000000000000001000000000000000010001
111111111111111111111111111111111111111111111111111111111111