111111
100001
1C0101

100001
111111
