1111111111
10C0000001
1000000001
1000000001
1000000001
1000000001
100000C001
1000000001
100C000001
1000000001
1000000001
10CC000001
1000000001
1000000001
1000000001
1110000001
1P10000001
1CC1100001
100000C011
10000000E1
1111111111
