1111111111
10E0000001
1000000001
1000000001
1000000001
1000000001
100000C001
1000000001
100C000001
1000000001
1000000001
10CC000001
1000000001
1000000001
1000000001
1000000001
10P0000001
1001100001
1000000001
1000000001
1111111111
